####T#
#.#..#
#...##
##.#.#
#....#
######

